#domain
hospital
#levelname
SAChuligans
#colors
blue: 0, A, B, C, D
#initial
++++++++++++++
+ +   C+ D+ B+
+ +    +  +  +
+ +    +  +  +
+ +    +  +  +
+ +    +  +  +
+ +    +  +  +
+ +    +  +  +
+ +    +  +  +
+ +    +  +  +
+ +    +  +  +
+ +    +  +  +
+ +    +  +  +
+ +    +  +  +
+ +    +  +  +
+   A       0+
++++++++++++++
#goal
++++++++++++++
+D+    +  +  +
+C+    +  +  +
+ +    +  +  +
+A+    +  +  +
+B+    +  +  +
+ +    +  +  +
+ +    +  +  +
+ +    +  +  +
+ +    +  +  +
+ +    +  +  +
+ +    +  +  +
+ +    +  +  +
+ +    +  +  +
+ +    +  +  +
+            +
++++++++++++++

#end
