#domain
hospital
#levelname
MACoronAI
#colors
red: 0,2, A
blue: 1,3, B
#initial
++++++++++++
+0A       ++
+         ++
+++++ ++++++
+         ++
+1B       ++
++++++++++++
++++++++++++
+2A       ++
+         ++
+++++ ++++++
+         ++
+3B       ++
++++++++++++
#goal
++++++++++++
+B        ++
+         ++
+++++ ++++++
+         ++
+A        ++
++++++++++++
++++++++++++
+B        ++
+         ++
+++++ ++++++
+         ++
+A        ++
++++++++++++

#end
