#domain
hospital
#levelname
SAKaren
#colors
red: 0, A
cyan: X
green: Y, L
blue: Z, W
pink: P
brown: H
purple: R
orange: Q
#initial
++++++++++++++++++++++++++++++++++++++++++++++++++
+0                                               +
+                                                +
+                                                +
+                                                +
+    +++++++++++++++++++++++++++++++++++++++++++++
+                                                +
+                                                +
+                                              +++
+                                              +A+
+                                                +
++++++++++++++++++++++++++++++++++++++++++++++++++
#goal
++++++++++++++++++++++++++++++++++++++++++++++++++
+                                                +
+                                          A     +
+                                                +
+                                                +
+    +++++++++++++++++++++++++++++++++++++++++++++
+                                                +
+                                                +
+                                              +++
+                                              + +
+                                                +
++++++++++++++++++++++++++++++++++++++++++++++++++
#end
